{
  "name": "Level 2",
  "key": "1007",
  "x": "1",
  "y": "2",
  "width": "7",
  "height": "9",
  "data": [
    3,3,3,3,3,0,1,
    1,0,0,1,0,2,0,
    0,2,1,0,2,0,0,
    0,1,0,1,2,0,1,
    1,0,2,0,0,2,0,
    0,2,1,0,1,0,1,
    1,0,0,2,0,0,0,
    0,1,2,0,2,2,0,
    2,0,1,1,0,0,2
  ],
  "entities": [
    3,3,3,3,3,0,22,
    0,0,0,0,0,0,2013,
    0,0,0,2005,0,22,22,
    0,0,0,0,0,0,0,
    22,22,22,0,22,22,22,
    20,1002,0,0,0,0,0,
    21,20,0,2004,22,22,22,
    20,1002,1002,0,0,1001,1001,
    22,22,22,22,22,22,22
  ]
}