{
  "name": "Level 3",
  "key": "1008",
  "x": "0",
  "y": "6",
  "width": "13",
  "height": "7",
  "data": [
    4,4,3,1,1,0,2,2,0,1,1,0,1,
    4,4,3,1,0,2,0,1,0,1,2,0,1,
    4,3,1,0,2,0,0,2,0,1,1,0,1,
    3,0,0,1,2,0,1,2,0,1,0,0,2,
    1,0,1,2,0,2,0,1,0,1,2,0,1,
    0,2,0,0,1,0,1,2,0,1,1,0,1,
    1,0,0,2,0,1,0,1,0,1,2,0,1
  ],
  "entities": [
    3,3,3,0,23,23,23,23,23,23,20,20,20,
    3,3,3,0,0,23,1012,23,23,20,20,20,20,
    3,3,0,0,0,0,0,23,24,23,23,23,23,
    3,0,0,2006,0,0,0,2001,0,0,1008,2013,0,
    0,0,0,0,0,0,1002,23,23,23,24,23,23,
    0,22,22,0,0,1002,20,20,20,20,20,20,20,
    0,0,0,0,20,20,20,20,20,23,23,20,21
  ]
}