{
  "name": "Cheesecakes!",
  "x": "1",
  "y": "1",
  "key": "1007",
  "width": "7",
  "height": "7",
  "data": [
    4,3,0,1,0,2,1,
    3,2,2,0,1,0,0,
    2,1,0,0,0,1,2,
    1,0,1,2,0,1,0,
    1,0,2,0,2,0,2,
    0,2,2,1,1,0,0,
    1,1,0,0,0,0,1
  ],
  "entities": [
    3,3,0,1008,1002,20,21,
    3,0,0,0,0,1002,1002,
    0,0,2005,0,0,0,0,
    0,0,0,2013,0,0,0,
    2004,0,0,0,0,22,22,
    0,0,0,2007,0,1001,1001,
    2002,2001,0,0,0,23,24
  ]
}