{
  "name": "Level 1",
  "key": "1004",
  "x": "2",
  "y": "2",
  "width": "7",
  "height": "8",
  "data": [
    4,4,4,4,4,3,3,
    3,3,3,3,3,2,0,
    0,2,1,0,2,0,0,
    0,0,0,1,2,0,1,
    1,0,1,0,0,2,0,
    0,2,0,0,1,0,1,
    1,0,0,2,0,0,0,
    0,1,2,0,2,2,0
  ],
  "entities": [
    3,3,3,3,3,3,3,
    3,3,3,3,3,20,20,
    0,0,0,0,0,0,0,
    0,0,0,0,0,0,0,
    0,0,0,0,2013,0,0,
    0,2002,0,0,0,0,1002,
    0,2001,0,0,1002,1002,20,
    0,0,0,1002,20,20,21
  ]
}